1111111111
1000X000E1
10C0111111
1000000<01
1000100001
10P0111111
1000000001
10C010W001
1000100001
1111111111